2 2 3 3 4 4 4 5 5 5 4 4 4 3 3 2 2
2 1 2 1 2 1 2 1 2 1 2 1 2 1 2 1 2
3 1 1 2 1 2 1 2 1 2 1 2 1 2 1 1 3
3 1 2 2 2 2 2 2 2 2 2 2 2 2 2 1 3
4 1 2 1 3 1 4 1 5 1 4 1 3 1 2 1 4
4 1 2 3 3 4 4 5 5 5 4 4 3 3 2 1 4
5 1 2 1 3 1 4 1 5 1 4 1 3 1 2 1 5
5 1 2 2 3 3 4 4 5 4 4 3 3 2 2 1 5
5 1 0 0 1 1 1 1 0 0 1 1 1 0 0 1 5